aali  -- excellent	__ 
abadani  -- never	__ kijana huyu hanywi pombe abadani.
abiria aliyeketi ubavuni pangu  -- the passenger sitting at my side
abiria  -- passenger
-abiri  -- learn from experience	__ kutokana na kifo cha wazee wake, ameabiri kwamba maisha ni magumu.
-abiri  -- predict, foresee	__ aliabiri kwamba mvua itanyesha leo.
-abiri  -- travel, navigate, sail	__ aliabiri kwenye mashua.
-abudu  -- worship, idolize; heshimu, ogopa omba, nyenyekea, tumikia	__ mila na itikadi pamoja na hayo imani ya kuabudu mizimu.
abwe!  -- wow! (expl)	__ 
-acha  -- abandon, neglect	__ kuku aliwaacha watoto wake.
-acha  -- allow, permit, let sby do sth; ruhusu mtu afanye jambo	__ wacha nitumie hadi jumatatu. alimwacha mtoto wake afanye atakavyo.
-acha  -- avoid, cease, stop doing sth	__ acha kucheza kamari.
-acha  -- divorce, separation; tengana na mtu, kitu, jambo au hali	__ amemwacha mkewe. kuku amewaacha watoto wake.
-acha  -- give instructions, leave a message to sby while away; toa masharti au maagizo ya kutekelezwa na mtu mwingine wakati umeondoka	__ aliacha maagizo kwa jirani zake.
-acha  -- leave sth behind; bakiza kitu, mtu, mali	__ aliacha mali nyingi aliipokufa. amekiacha chakula nusu sahani. nilimwacha fulani posta.
-achama  -- gape, stare, gawk	__ mbona unaachama?
-acha mavanga  -- acha udanganyifu au uongo (idm)	__ 
-acha mkono  -- die (idiom)	__ alituacha mkono zamani.
-achana  -- be separated	__ kuachana naye
-achana nasi  -- depart/leave us; die	__ 
acha!  -- neno la kuonyesha mshangao na furaha	__ acha wee!
-acha  -- pardon, release, let go	__ nilimkamata mwizi wa mifuko na kisha nikamwachilia.
-acha  -- pass by sth [directions]; pita kitu fulani	__ acha nyumba ili mkono wa kushoto kisha uende moja kwa mjoa mpaka kwa hilo jengo. acha hoteli mkono wa kulia uende kama mitamia hivi.
-acha  -- resign from sth; kutoendelea kujihusisha na kitu, shughuli, shirika fulani	__ ameacha kazi.
achari  -- pickles	__ 
-achia  -- leave to sby	__ aliniachia simu yake nimsajili katika mtandao wa duo.
-achilia  -- acquit, discharge	__ mahakama ilimwachilia huru mshtakiwa.
-achisha  -- stop sby from doing sth	__ achisha ziwa [wean a child]. achisha kazi [fire terminate sby employment].
adabu  -- respect, good manners	__ 
ada  -- custom, tradition; habit	__ ada za harusi. ana ada ya kuchelewa kazini kila siku. ada ya mja hunena, muungwana ni kitendo
~a daima  -- lasting	__ upendo wa daima; asipojua kusema daima hataelewana na wenzake.
adapta  -- adapter  (tech)
ada ya pango  -- rent	__ analipa shilingi ngapi ada ya pango?
ada ya pango  -- rent (n)
ada ya uhamisho  -- transfer fee	__ 
~a dayo  -- dial-up (adj)  (tech)
adhabu  -- punishment, penalty; persecution	__ mwanafunzi atapata adhabu kali. kibarua cha kuchuma majani chai ni adhabu.
adha  -- inconvenience, nuisance, annoyance	__ mbona hakunizaa katika ulimwengu usiokuwa na adha na ubaya?
~a dhati  -- genuine, true	__ mapenzi ya dhati kwa sana
-adhibiwa  -- be punished	__ ni haki mtu kuadhibiwa kwa jambo ambalo hakufanya?
-adhibu  -- punish, harass	__ serikali itawaadhibu wale wanavunja sheria. akiniadhibu basi mimi nitaripoti kwa wazee wake.
-adhimisha  -- commemorate, celebrate, glorify, honor; sherekea jambo au siku kwa kuitukuza, ipa heshima	__ nchi yetu iliadhimisha miaka thelathini ya kkupatikana kwa uhuru.
adhimisho  (ma)  -- commemoration, celebration, observance	__ 
adhimu  -- bountiful, much	__ alikuwa na mali adhimu
adhimu  -- exalted, glory, prestigious, honorable	__ kulikuwa na sherehe adhimu mtaani hivi karibuni.
-adhiri, -aziri  -- disgrace, slander	__ aliniaziri kwa kunidai pesa zake hadharani (in public).
adhuhuri  -- noontime	__ habari za adhuhuri?
-adibu  -- teach good manners; fundisha mwenendo mwema au tabia njema; kuwa adabu	__ mzee alimwadibu binti yake jinsi ya kuwashughulikia wageni.
~adilifu  -- just and good; righteous	__ kiongozi mwadilifu. daktari Nozi alikuwa kijana mwadilifu.
adilifu  -- just and good; righteousness	__ yote yalikuwa chini ya usimamizi mzuri na adilifu wa dada yake
-adili  -- judge impartially; be impartial, be just	__ mkuu wa wilaya anasifika sana katika kuadili shughuli mbalimbali za wilaya.
adili  (ma)  -- justice, righteousness, impartiality	__ hakimu alitumia maadil;i alipowahukumu washtakiwa.
adili  (ma)  -- moral training, teachings	__ shule yetu inaipa umuhimu mkubwa kipengele cha maadili.
-adilisha  -- elevate, moralize	__ yaonekana kifungo alichopewa kimemwadilisha.
-adimika  -- be scarce, rare; unobtainable	__ yahe, mbona umeadimika siku hizi kama barafu ya kukaanga? mchele umeadimika.
adimu  -- rare, scarce	__ huu si msimu wa maembe na ndiyo maana yamekuwa adimu.
adinasi  -- person noble birth; person	__ baadhi ya shule katika Uingereza zinapendwa na kina adinasi. kila adinasi ana kasoro zake.
ado ado  -- moving slowly [not wanting to move fast thus delaying]; mwendo wa polepole  (slang)
adui  -- enemy, rival	__ 
aenda kazini kuomba ruhusa anikaguze jiji  -- he's going to office to ask for permission to see the city.
afadhali  -- preferable (by choice), better	__ afadhali kupumzika kuliko kuhangaika burebure.
afanalek!  -- oh remember now!  (expl)
afande  -- officer x, soldier x	__ afande Peter
afanyeje?  -- what should he do?	__ 
-afiki  -- agree with; suit, satisfy; kubali	__ mimi nililiafiki shauri lake la kufungua zahanati kijijini.
-afikiana  -- agree with, concur	__ mtazamo wake unaafikiana na malengo yetu
afisa  -- office	__ 
afuana  -- (response to ahsante/thank you)
afueni  -- wellness	__ nakutakia afueni ya haraka
afyuni  -- opium	__ 
-aga  -- ask permission, bid goodbye	__ walimwaga maziwa. aliniaga alipokwenda hospitali.
-aga dunia  -- say a last farewell before dying.	__ 
agano  (ma)  -- understanding; agreement, contract	__ agano lake lina mashaka sana.
-aga  -- quit  (tech)
aghalabu  -- usually, as a rule; mara kwa mara au kwa kawaida	__ watu wanaofanya mazoezi ya mwili aghalabu huwa na afya njema. mtu yule aghalabu hunitembelea kila jumapili.
-agiza  -- instruct, order	__ mimi naagiza chakula
ahadi za kiswahili  -- ahadi za uongo, zisizoaminika  (idm)	__ 
ahali  -- wife [i-zi]	__ 
ahera  -- life after death	__ 
ah! -- grief  (expl)
~a hiari  -- optional  (tech)
-ahidi  -- promise  (v)	__ baba alimuahidi nini roda akifanya vizuri muhula ujao?
-ahirisha  -- postpone, delay, make wait	__ waliuahirisha mkutano.
-ahirishwa  -- be postponed__ mechi tuliosubiri imeahirishwa kwa sababu ya hali ya hewa.
ahueni  -- better condition after illness; nafuu	__ 
-aibika  -- b humiliated, shamed	__ 
-aibikia kitu  -- be ashamed of sth	  __ sikuona sababu yoyote ya kuliaibikia kabila langu
-aibisha  -- embarass sby	__ 
aibu  -- shy	__ 
aidha  -- further, moreover	__ aidha, nyasi ndefu inafaa kuondolewa.
aikoni  -- icon  (tech)	__ badilisha aikoni.
aila  -- clan, kinfolk	__ 
-aili  -- blame, accuse	__ 
aina  -- category; namna, jinsi, jamii, kundi
ainati -- various, sundry	__ nje ya kasri hiyo, ilikuiwapo miti ainatiu iliyonawiri kwa rutuba.
aina ya chapa  -- face type  (tech)
-ainisha  -- classify, categorize	__ utamaduni uainisha wa jamii.
aisee!  -- i say!  (expl)
-ajabia  -- be astonished, dumbfounded	__ naviajabia viroja vya jijini.
-ajabisha  -- make amazed
ajabu  -- extreme, incredible	__ kulikuwa na mvua kubwa ajabu.
ajabu!  -- surprising (expl)	__ 
ajali  -- accident	__ tulifikiri tutachelewa sana kwa sababu ya ajali hiyo ya matatu.
ajapoaswa  -- even if warned	__ mkata hana kinyongo ajapoaswa.  (meth)
ajenda  -- agenda
ajenti  -- agent  (biz)
ajili ya  -- because, for reasons of; kuonyeshea sababu fulani	__ nimezuru mji wa arusha kwa ajili ya kuona chemchemi za maji zinavyotiririka.
ajira  -- employment	__ ajira ya watoto
-ajiri  -- employ, hire	__ 
-ajiriwa  -- be employed	__ 
-ajizi  -- be lazy, negligent	__ alipewa kazi kuifanya lakini akawa anaiajizi.
ajizi  -- lazy, sluggish; wala agiza; uvivu, ulegevu, uzembe, uzito wa kufanya jambo __ mtu ajizi. ana ajizi sana katika kufanya kazi.
ajuaye yuajua  -- he who knows, knows
ajuza  -- very old woman	__ 
akali  -- a few	__ akali ya vitu
~a karibu  -- close (a)  (tech)
~a karibu sana  -- closest  (tech)
~a kati  -- mean  (tech)
akaunti  -- account  (tech)
~a kawaida  -- common  (tech)
~a kiambo  -- locale  (tech)
akiba  -- savings, reserve, stock, spare; -kitu kilichotengwa kwa ajili ya manufaa ya baadae.	__ benki ya akiba.  ni mahali gani naweza kuweka akiba yangu bila wasiwasi wowote?
akidi  -- marriage ceremony	__ 
~a kidini  -- religious
-akifisha  -- punctuate
akili fugutu  -- akili iliyo na kasoro, akili dhaifu  (idm)	__ 
akili  -- intelligence, intellect, mind, abilities	__ 
akili itulie  -- relax mind	__ 
akili mauzauza  -- akili isiyo nzuri, akili ovyoovyo  (idm)	__ 
akili ni mali  -- wits are wealth  (meth)
akili taahira  -- mental retarded
akili timamu  -- sanity
akili ya kuzaliwa  -- native intelligence
akina  -- group of people of similar sth	__ 
akina sisi  -- we the like of us	__ 
akina yahje  -- common people	__ 
akisami  -- fractions	__ 
-akisi  -- mirror (v)  (tech)
-akisi  -- reflect, echo, reverberate	__ kiyoo kiliuakisi uso wake. maji ya bwawa yaliakisi nyumba na miti iliyoizunguka.
-akisi  -- reflect, manifest, exhibit	__ tabia yake inaakisi waziwazi kiburi chake.
akrabu za saa  -- hands of clock, compass indicator
~a kuaminika kiotomati  -- auto-reliable  (tech)
~a kuaminika  -- reliable  (tech)
~a kuu  -- master  (tech)
ala!  -- annoyance, impatience (expl)	__ 
alaa  -- oh! I see  (expl)	__ 
alacho  -- anachokula
alakulihali  -- by all means possible, any way; kwa vyovyote vile au kwa hali yeyote ile	__ fanya alakulihali uonane naye leo hii.
alama  -- mark, sign	__ kuna duara jeupe halafu alama ya - ndani yake
alama  -- mark  (tech)
alama tobo  -- bullet points  (tech)
alama ya dukuduku  -- elipsis ...	__ 
alama ya kistari  -- hyphen 
alama ya mtajo  -- quotation marks
alama ya ritifaa  -- apostrophe sign
alama ya usawa  -- equal sign	__ 
alama ya usemi  -- single quotation marks
-alamisha  -- bookmark (v)  (tech)
alamisho  -- bookmark link  (tech)
alamsiki  -- good night
ala  -- sheath, scabbard, case	__ ala ya kisu
alasiri  -- 100 tshs; shilingi mia moja  (slang)
alasiri  -- late afternoon	__ ilikuwa alasiri na siagi yote ikayeyuka.
ala  -- tool, instrument	__ msamiati wa ala za muziki.
alhamdulilahi  -- praise God! (expl)	__ 
alhasili  -- in short	__ (conj)
alihatarisha maisha yake kwa kumwokoa mtoto yule.
alijisemea  -- he told himself
-alika  -- invite, summon
-alika  -- invite  (tech)
alimradi  -- therefore, so	__ 
alinialika kumtembelea jijini pindi nikinafasika  -- he invited me to visit him in town when I would be able  (phrase)
aliniruhusu niitumie  -- she let me use it  (phrase)	__ 
alitabiri kwamba chama tawala kitashinda katika uchaguzi.
aliumbwa akaumbika  -- she is buxom, sexy, full-bodied  (phrase)	__ 
almari  -- chest of drawers
almasi  -- diamond	__ mgodi wa almasi
almuradi  -- taz ilimradi
alosto  -- broke; kuishiwa pesa  (slang)
amali  -- work, career	__ 
amana  -- deposit, security, a thing entrusted to sby; kitu unachomwekea
amani  -- peace, safety	__ nimepata amani
amara  -- aid, help, assistance	__ haja amara?
amara  -- urgent work / business	__ alikuwa na amara na ndiyo maana, hakuweza kuzungumza na mimi vizuri njiani.
amati  -- aunt (paternal)
-ambaa  -- skirt past, pass near sth w/o touching; stay away from, avoid	__ alikiambaa chombo gatini. alambaa hatari (escape fm danger)
ambapo  -- while	__ 
-ambata  -- stick, adhere, attach	__ ambatanisha majina na picha.
-ambilika  -- be approachable; be ready to listen to advice	__ juma ni mtu ambaye haambiliki hasemezeki.
-ambua  -- get, gain	__ hakuna alichoambua ingawa alikuwa akienda shuleni kila siku. aliambua patupu.
-ambua gome  -- peel off bark	__ 
-ambua ngozi  -- shed skin	__ 
-ambua nyayo  -- kwenda kwa miguu kwa muda mrefu  (idm)	__  tulienda tukiziambua nyayo na kuzungumza hili na lile.
-ambua  -- remove, peel off	__ ambua vitunguu.
-ambukiza  -- infect, be contagious	__ magonjwa ya kuambukiza
ambukizo  (ma)  -- infection	__ 
-ambulia nunge  -- gained nothing; kosa kupata chochote	__ hapa umeambulia nunge.
-ambulia  -- win, obtain; ishia kupata	__ ambulia patupu. chama chao hakikuambulia kitu wakati wa uchaguzi mdogo. alishtuka alipoona alichoambulia.
ameligeuza  -- inside out	__ 
amiba  -- amoeba	__ 
